*****
*s..*
***.*
*e..*
*****