************************************************************
*..........................................................*
*****.***********.********...********************.**********
*.***.*............**......**..******************.*...******
*.***.***.***.****.**.********.....***......*****.*.*.....**
*.........*...**...**.************.***.....******...*****.**
***.*****e..****.****.****..******.*****.****************..*
*...******.......*........................................s*
************************************************************