***************************************************************************************************************************************************************************
*........................................................................................................................................................................s*
*.........................................................................................................................................................................*
*.........................................................................................................................................................................*
*e........................................................................................................................................................................*
***************************************************************************************************************************************************************************