********************
*s.................*
*****.***********.**
*.***.*............*
*.***.***.***.****.*
*.........*...**...*
*********...****.***
*e..******.......***
********************